10 10
1000010101
0S10011000
1001000011
0110001011
110b11a011
1001001011
1B11011011
0011100A11
1001011011
1100000E11