11 11
000000000S1
0111110111E
0111110111A
0111110111a
01111101110
01111101110
10000000001
01111101111
01111101111
01111101111
01111101111